1
1
1   1111111111111111111111111
1   1000000000110000000000001
1   1011000001110000000000001
1   100100000000000000000000111111
111111111011100001110000000000001
100000000011000001110111111111111
11110111111111000000011111111
11110111111111011101010000001
11111111111111111111111111111

11111111111111111111111111111
11000000110101011100000010001
100000000000000011000S0010001
10000000000000001101010010001
11000001110101011111011110001
11110111 1110101 101111000001
11111111 1111111 111111111111