

   NO    ./pics/bluestone.xpm
C 4,0,197
SO       	     ./pics/colorstone_EA.xpm

EA 					./pics/purplestone_EA.xpm
F 4,   2 0 6 ,    1 9 7
WE ./pics/wood.xpm
1
1
1
1   1111111111111111111111111
1   1111111111111111011111011
1   1111111111111111111111111
1   1000000000110000000000001
1   1011000001110000000000001
1   100100000000000000000000111111
111111111011100001110000000000001
100000000011000001110111111111111
11110111111111000000011111111
11110111111111011101010000001
11111111111111111111111111111

11111111111111111111111111111
11000000110101011100000010001
10000000000000001100000010001
10000000000000001101010010001
11000001110101011101011110001
11110111 1110101 101111000001
11111111 1111111 111111111111

11111111111111111111111111111
10000000000000000000000000001
10000000000000000000000000001
10000000000000000000000000001
10000000000000100000000000001
10000000000000N00000000000001
10000000000000000000000000001
10000000000000000000000000001
10000000000000000000000000001
11111111111111111111111111111