NO ./pics/wood.xpm
SO ./pics/wood.xpm
EA ./pics/wood.xpm
WE ./pics/wood.xpm
C 68, 142, 228
F 229,204,255

11111111111111111111111111111
11000000110101011100000010001
1000000000000S001100000010001
10000000000000001101010010001
11000001110101011101011110001
11110111 1110101 101111000001
11111111 1111111 111111111111