NO ./pics/bluestone.xpm
SO ./pics/colorstone.xpm
EA ./pics/purplestone.xpm
WE ./pics/wood.xpm
C 68, 142, 228
F 229,204,255

11111111111111
10000000000001
10000000000001
10000000000001
100000N0000001
10000000000001
10000000000001
10000000000001
11111111111111
